1111111111111
10010100000C1
1000011111001
1P001100000E1
1111111111111