1111111111111111111111111111111111
1C010000000X0C000011100000C00C0001
1P01010100100000101C0000X000010101
101001001010101X0011110C0000010101
1000C0000000E0000000000C0C000C0001
1111111111111111111111111111111111